1 1 1 1 19 1 1 1 1 1
1 0 21 0 19 0 0 0 0 1
18 18 18 18 2 18 18 18 18 18
1 0 0 0 19 0 0 0 0 1
1 0 0 0 19 0 0 7 0 1
1 20 0 0 19 0 0 0 0 1
1 0 0 0 19 0 0 0 0 1
1 7 0 0 19 0 21 0 0 1
1 0 0 20 19 0 0 0 0 1
1 1 1 1 19 1 1 1 1 1
